
F 184,113,39
C 51,198,227
NO ./maps/xpm/no_redbrick.xpm
SO ./maps/xpm/so_redbrick.xpm


EA ./maps/xpm/ea_redbrick.xpm








WE                                                ./maps/xpm/we_redbrick.xpm
           11111111111111111
11111111111100001   101
10000000000000001  1101
10000000000000001 11101
10000000000000001   101
11111111110000001111111111
         10000000000000001
11111111110000000N00000001
11111111110000000000000011
10000000000000001111111111
10000000000000001
10000000000000001
10000000000000001
11111111111111111
