NO ./maps/xpm/no_redbrick.xpm
SO ./maps/xpm/so_redbrick.xpm
EA ./maps/xpm/ea_redbrick.xpm
WE ./maps/xpm/we_redbrick.xpm

F 184,113,39
C 51,198,227

11111111111111111111111111111
10000000001100000000000000001
10110100011100000001111111111
11111111110000000000000000111
10110000011100000000011111111
11111111100110000011101111111
11110110000011011100000010001
11110110000010011101010010001
10000000000000000000000001001
10000000111100010000N00001001
100000001  100110101110000001
10000000111110000001 10100001
11111111111111111111 11111111
11111111111111111111111111111