NO ./maps/xpm/no_redbrick.xpm
SO ./maps/xpm/so_redbrick.xpm
EA ./maps/xpm/ea_redbrick.xpm
WE ./maps/xpm/we_redbrick.xpm

F 184,113,39
C 51,198,227

111111111111111111111
111111111111000011001
100000000000000011001
100000000000000010001
100000000000000011001
111111111100000011001111
         100000000000001
         10000000N000001
111111111100000000000011
100000000000000011100111
100000000000000011100001
100000000000000011000001
100000000000000011000001
111111111111111111111111
